12
48
20 20 20 20 20 20 20 20 20 20 20 20
20  1  1  1  1  1  1  1  1  1  1 20
28 21 21 21 21 21 21 21 21 21 21 29
28 22 22 22 22 22 22 22 22 22 22 29
28 22 22 22 22 22 22 22 22 22 22 29
28 22 22 22 22 22 22 22 22 22 22 29
28 22 22 22 22 22 22 22 22 22 22 29
28 22 22 22 22 22 22 22 22 22 22 29
28 22 22 22 22 22 22 22 22 22 22 29
28 22 22 22 22 22 22 22 22 22 22 29
28 22 22 22 22 22 22 22 22 22 22 29
28 22 22 22 22 22 22 22 22 22 22 29
28 22 22 22 22 22 22 22 22 22 22 29
30 23 23 23 23 23 23 23 23 23 23 31
30 23 23 23 23 23 23 23 23 23 23 31
30 23 23 23 23 23 23 23 23 23 23 31
30 23 23 23 23 23 23 23 23 23 23 31
30 23 23 23 23 23 23 23 23 23 23 31
30 23 23 23 23 23 23 23 23 23 23 31
30 23 23 23 23 23 23 23 23 23 23 31
30 23 23 23 23 23 23 23 23 23 23 31
30 23 23 23 23 23 23 23 23 23 23 31
30 23 23 23 23 23 23 23 23 23 23 31
30 23 23 23 23 23 23 23 23 23 23 31
32 24 24 24 24 24 24 24 24 24 24 33
32 24 24 24 24 24 24 24 24 24 24 33
32 24 24 24 24 24 24 24 24 24 24 33
32 24 24 24 24 24 24 24 24 24 24 33
32 24 24 24 24 24 24 24 24 24 24 33
32 24 24 24 24 24 24 24 24 24 24 33
32 24 24 24 24 24 24 24 24 24 24 33
32 24 24 24 24 24 24 24 24 24 24 33
32 24 24 24 24 24 24 24 24 24 24 33
32 24 24 24 24 24 24 24 24 24 24 33
32 24 24 24 24 24 24 24 24 24 24 33
34 25 25 25 25 25 25 25 25 25 25 34
34 25 25 25 25 25 25 25 25 25 25 34
34 25 25 25 25 25 25 25 25 25 25 34
34 25 25 25 25 25 25 25 25 25 25 34
34 25 25 25 25 25 25 25 25 25 25 34
34 25 25 25 25 25 25 25 25 25 25 34
34 25 25 25 25 25 25 25 25 25 25 34
34 25 25 25 25 25 25 25 25 25 25 34
34 25 25 25 25 25 25 25 25 25 25 34
34 25 25 25 25 25 25 25 25 25 25 34
34 25 25 25 25 25 25 25 25 25 25 34
26 26 26 26 26 26 26 26 26 26 26 26
27 27 27 27 27 27 27 27 27 27 27 27